[MAP_DATA]
1, 1, 1, 1, 1, 1, 1, 1, 1, 1, 1,
1, 0, 0, 0, 0, 0, 0, 0, 0, 0, 1,
1, 0, 0, 0, 0, 3, 0, 0, 0, 0, 1,
1, 0, 0, 0, 0, 0, 0, 0, 0, 0, 1,
1, 0, 2, 0, 4, 4, 0, 0, 0, 0, 1,
1, 0, 0, 0, 4, 0, 0, 0, 0, 0, 1,
1, 0, 2, 0, 0, 0, 0, 0, 0, 0, 1,
1, 0, 1, 1, 0, 0, 1, 0, 0, 0, 1,
1, 0, 0, 0, 0, 0, 0, 0, 0, 0, 1,
1, 0, 0, 0, 0, 0, 0, 0, 0, 0, 1,
1, 1, 1, 1, 1, 1, 1, 1, 1, 1, 1,

[SPRITES_DATA]
{6.0, 8.5, 0, 0, 0, 0,0, 0, 0,  10},
{3.5, 6.5, 0, 0, 0, 0,0, 0, 0,  10},
{5.5, 5.5, 0, 0, 0, 0,0, 0, 0, 9},
{7.5, 1.5, 0, 0, 0, 0,0, 0, 0, 8},
{3.5,  2.5, 0, 0, 0, 0,0, 0, 0, 11},
